20 4 0 0
.............
.#.#.#.#.#.#.
.............
.#.#.#.#.#.#.
.............
.#.#.#@#.#.#.
.............
.#.#.#.#.#.#.
.............
.#.#.#.#.#.#.
.............
