40 3 2 0
@............
.#.#.#.#.#.#.
.............
.#.#.#.#.#.#.
.............
.#.#.#.#.#.#.
.............
.#.#.#.#.#.#.
.............
.#.#.#.#.#.#.
.............
