40 3 3 0
@............
.###.#.#.###.
.............
.#.#.#.#.#.#.
.............
.###.#.#.###.
.............
.#.#.#.#.#.#.
.............
.###.#.#.###.
.............
