40 2 4 1
@............
.###.#.#.###.
.#.........#.
.#.#.#.#.#.#.
.............
.#.#.#.#.#.#.
.............
.#.#.#.#.#.#.
.#.........#.
.###.#.#.###.
.............
